##
# This are the list of extensions that say
# whether request should be prerendered.
##

default        "yes";

"~*\.js"       "no";
"~*\.css"      "no";
"~*\.xml"      "no";
"~*\.less"     "no";
"~*\.png"      "no";
"~*\.jpg"      "no";
"~*\.jpeg"     "no";
"~*\.gif"      "no";
"~*\.webp"     "no";
"~*\.pdf"      "no";
"~*\.doc"      "no";
"~*\.txt"      "no";
"~*\.ico"      "no";
"~*\.rss"      "no";
"~*\.zip"      "no";
"~*\.mp3"      "no";
"~*\.rar"      "no";
"~*\.exe"      "no";
"~*\.wmv"      "no";
"~*\.doc"      "no";
"~*\.avi"      "no";
"~*\.ppt"      "no";
"~*\.mpg"      "no";
"~*\.mpeg"     "no";
"~*\.tif"      "no";
"~*\.wav"      "no";
"~*\.mov"      "no";
"~*\.psd"      "no";
"~*\.ai"       "no";
"~*\.xls"      "no";
"~*\.mp4"      "no";
"~*\.m4a"      "no";
"~*\.swf"      "no";
"~*\.dat"      "no";
"~*\.dmg"      "no";
"~*\.iso"      "no";
"~*\.flv"      "no";
"~*\.m4v"      "no";
"~*\.torrent"  "no";
"~*\.ttf"      "no";
"~*\.woff"     "no";
"~*\.svg"      "no";
"~*\.eot"      "no";
